(---------------------------------------------------------------------)
(                                                                     )
(    QUICKPLACE LOG                                                   )
(                                                                     )
(    Drawing          : NVR.brd                                       )
(    Software Version : 16.6P004                                      )
(    Date/Time        : Mon Nov 13 09:34:24 2017                      )
(                                                                     )
(---------------------------------------------------------------------)


